originalEntry	fuzzyMatchedEntry	fuzzyMatchScore
n41 09.580 w071 36.126	andy's way	27
2nd cliff path	block island public school	45
in my bed! (gifted)	dinhgy beach	45
re-hidden on 4/30/16	new shoreham	45
re-hidden on 5/28/16	new shoreham	45
playground book box	payne overlook	46
under stairs by gazebo	dunn's bridge	46
lakeside dr	snake hole road	46
inside a log	block island chamber of commerce	47
neptune house bush by flag pole	beane point	47
sit your butt or take a putt	tom's point	47
tin can in ruins	martin's point	47
john e. tughole	rodman's hollow	47
lakeside drive	hodge family wildlife preserve	47
sit your but or take a putt	tom's point	47
pettit lot	long lot trail	48
none given	beane point	48
firehouse bingo	fresh pond	48
sahara's field	ballard's beach	48
"near chef statue, under boat"	sachem pond	50
hygeia house yard	snake hole road	50
garden in downtown	beane point	50
a kind local	block island historical society	50
rebecca statue	greenway trail	50
wwi memorial	block island historical society	50
tree trunk	greenway trail	50
bingo prize	ball o' brien park	50
tennis courts	lewis point	50
heinz field	hodge family wildlife preserve	50
entrance of tulip and avatar	beane point	50
bi playground	spring pond	50
gift	north light	51
unknown	cannon at legion park	51
ragged sailor building alley under hydrangeas	airport	51
take a putt	block island state airport	51
atop porta potty heinz field	airport	51
mary macgill store	martin trail	52
walkers welcome	grace's cove	52
in shrub near rebeccas restaurant	new shoreham	52
walking path	legion park	52
pots and kettles	dickens point	52
in a boot	new harbor	53
lakeshore drive	snake hole road	53
gifted by clever friends	fresh pond	53
in veterans park	nathan mott park	53
toy boat race	grace's cove	53
arts & craft guild	martin trail	53
lobster pot christmas tree	spar point	54
hidden on a support beam of a gazebo	surf beach	54
playground	payne road greenway	54
stone wall	charlestown beach	54
st andrews stone wall chapel st	fresh pond	54
bagel shop	block island public school	54
in my backpack!	dinhgy beach	54
duval	vaill beach	54
under a canon near rustic rides	corn neck road	55
indian grave yard	'indian' cemetery	55
flower walk	plover hill	55
west side rd	west beach	55
gifted to me by a friend who found it.	spring pond	55
sea breeze inn	dunn's bridge	56
hygeia house side driveway	greenway	56
turnstile up from smilin' thru in a cedar tree in open field	harrison loop	56
united states	block island state airport	56
se lighthouse	southeast light	57
walkers way	andy's way	57
in a tree trunk	spring street	57
not sure	barlow's point	57
bingo	spring pond	57
dorrys pathway	andy's way	58
"window sill in mystic, ct"	meadow hill	58
stonewall on backside of graveyard	vaill beach	58
red bird parking lot	spring pond	58
walkers welcome -in tree	tom's point	58
path off ocean ave.	post office	58
tree stump	spring street	58
heinz field on top of porta potty	tom's point	58
near paul garra memorial bench	vaill beach	58
playground tree	payne road greenway	59
northern clayhead :)	clay head trail	59
trails off connecticut ave	mott trail	60
lighthouse	southeast light	60
liotto	long lot trail	60
small garden behind club soda	ballard's beach	60
between dorries and gracies	grace's cove	60
dories	enchanted forest	60
clayhead in a root!!! :)	clay head trail	61
bluestone	charlestown beach	61
painted rock	payne overlook	62
west side	west beach	63
outside beachhead	surf beach	63
pots&kettles area	lewis point	63
next to fence in clayhead	clay head trail	63
dingy dock	dinhgy beach	64
in a tree	spring street	64
john e pond	fresh pond	64
dorries	dorry's cove	64
stone wall near beachead picnic area	ballard's beach	66
mansion ruins	mansion beach	66
gazebo at ocean view	ocean view pavilion	66
ocean view- eaves of gazebo	ocean view pavilion	66
second bluffs	mohegan bluffs	67
american legion	legion park	67
middle pond	middle earth	67
grove point	spar point	67
clayhead in a tree	clay head trail	67
green gables	greenway	68
mailbox at labyrinth	sacred labyrinth	68
labrynth	sacred labyrinth	68
wild life refuge	hodge family wildlife preserve	68
overlook mohegan	payne overlook	69
old bluffs overlook	payne overlook	69
across from cemetery	dodge cemetery	69
cemetery stone wall	dodge cemetery	69
fred benson snack bar	fred benson town beach	70
2nd bluff	mohegan bluffs	70
2nd bluffs	mohegan bluffs	71
old mill loop- tree	old mill road	72
canon	cannon at legion park	72
near harborside inn	new harbor	72
tree at indian cemetary	'indian' cemetery	72
overlook wall	attwood overlook	72
ocean view garden	ocean view pavilion	72
nathan motts sign	nathan mott park	73
black rock trails	black rock beach	73
ocean view hotel	ocean view pavilion	73
black rock overlook	black rock beach	73
grace point	beane point	73
loefflers loop	loffredo loop	74
hodges	hodge family wildlife preserve	75
black rock bluff	black rock beach	75
atwood	attwood overlook	75
cooneymus road	cooneymus beach	76
sandy point	spar point	76
ocean view park	ocean view pavilion	76
martin lots	martin's point	76
mill pond rd	old mill road	76
black rock road	black rock beach	77
old mill loop	old mill road	77
enchanted woods	enchanted forest	77
gracies	grace's cove	77
clayhead	clay head trail	79
mott property	martin property	79
solveiken property	solviken	79
solvieken dog water fountain	solviken	79
locker room chamber of commerce	block island chamber of commerce	79
off old mill rd	old mill road	79
old pet cemetery	dodge cemetery	80
martins lot	martin's point	80
andies way	andy's way	80
mohican bluff	mohegan bluffs	81
north lighthouse	north light	81
mohegan stairs	mohegan trail	81
rodmans hollow area	rodman's hollow	82
cooneymus rd	cooneymus beach	82
cooneymus rd.	cooneymus beach	82
behind historical society	block island historical society	82
laredo loop	loffredo loop	83
rodhams hollow	rodman's hollow	83
southeasr lighthouse window	southeast light	84
bunnell beach	block island state beach	86
beach ave. trails	baby beach	86
woods pond	great salt pond	86
ocean view path near ballards	ocean view pavilion	86
cooneymous trail	mott trail	86
maze in a tree	the maze	86
long lots	long lot trail	86
in a tree near the gazebo	the maze	86
mazzur trail	elizabeth dickens trail	86
marsh hollow entrance-left in bike basket	marsh hawk hollow	86
mott nature trail	mott trail	86
jones trail	elizabeth dickens trail	86
1661 farm	abrams animal farm	86
andys way rock wall	andy's way	86
breed land trail	mott trail	86
lewis dickens trail	hyland trail	86
black rock trail	mott trail	86
old mill trail	elizabeth dickens trail	86
mohegan bluff lookout	mohegan bluffs	86
in tree on black rock rd.	black rock beach	86
golden grove / settlers rock	black rock beach	86
southeast lighthouse	southeast light	86
town fountain	fred benson town beach	86
south east lighthouse rock	black rock beach	86
indian monument across from hog pen!	'indian' cemetery	86
tree in front of harbor church	new harbor	86
stone wall ocean ave before depot	ocean view pavilion	86
mohegan bluff near overlook	attwood overlook	86
pebbly beach	block island state beach	86
vfw park	ball o' brien park	86
‘rona orb in the lobster trap tree	the maze	86
ocean house	ocean view pavilion	86
clay head maze	the maze	86
old mill near nathan mottt	nathan mott park	86
dickenson trail	elizabeth dickens trail	86
cooneymus cove	cow cove	86
tree near horse farm	mitchell farm	86
legion way in a tree	andy's way	86
dory's beach	block island state beach	86
grace's beach	block island state beach	86
turnip trail	elizabeth dickens trail	86
green way off cooneymus rd. in tall grass	andy's way	86
dickens path in tree	dickens point	86
bottom of broken stairs by overlook	attwood overlook	86
winfield dodge farm	turnip farm	86
trustrum dodge memorial	dodge cemetery	86
tree on legion way outside of oark	andy's way	86
clayhead maze	the maze	86
"rodmans hollow, in a tree"	rodman hollow	86
highland trail	elizabeth dickens trail	86
ocean view pavillion in a pile of bricks	ocean view pavilion	86
benson beach	block island state beach	86
maze/ clayhead	the maze	86
long trail pond	elizabeth dickens trail	86
long lot path in a stone wall	long lot trail	86
lewis dickens preserve	dickens point	86
"maze, in a tree"	the maze	86
dories cove	dorry's cove beach	86
bench near old mill marker	old harbor point	86
martin lot	martin property	86
the point	barlow's point	86
under a piece of driftwood at the poiny	cannon at legion park	86
between mansion and scotch buried in sand (pumpkin)	mansion beach	86
inside the cannon!	the maze	86
american legion memorial pole	legion park	86
magellan's tree	andy's way	86
south east beach	baby beach	86
esta's park	ball o' brien park	86
west side beach	baby beach	86
corn neck rd in yellow moss rock wall next	black rock beach	86
martin lots in stonewall	martin property	86
haunted trail	elizabeth dickens trail	86
square stone wall off of cooneymus	cooneymus beach	86
winfield dodge foundation	dodge cemetery	86
old mill in a rock pile	old mill road	86
"the vale, bi"	the maze	86
foundation off of cooneymus rd.	cooneymus beach	86
near the statue of hebe (cupbearer to the gods at mount olympus)	block island chamber of commerce	86
dorries cove	cow cove	86
swamp/ we love you	fresh swamp	86
near dinghy beach	baby beach	86
dickens preserve	hodge family wildlife preserve	86
kings lot	long lot trail	86
path of old hotel	block island chamber of commerce	86
in town	fred benson town beach	86
2nd bluffs near railing	mohegan bluffs	86
dodge farm	abrams animal farm	86
second bluffs trail	hyland trail	86
murphy's trail	elizabeth dickens trail	86
high street stone wall	spring street	86
rock wall near block island school	black rock beach	86
memorial bench in old harbor	new harbor	86
behind the surf restaurant	surf beach	86
peckham farm road	turnip farm	86
hodge family wildlife reserve (in a tree)	hodge preserve	86
"the enchanted forrest, high up in a tree"	enchanted forest	86
the cannon	cannon at legion park	86
ball o'brien park tennis courts	ball o' brien park	86
murphy trail	elizabeth dickens trail	86
"bluffs, under some rocks"	mohegan bluffs	86
site of ocean view hotel under wooden boardwalk.	ocean view pavilion	86
carey lot by the bear (??)	long lot trail	86
behind mohegan bluff monument stone	mohegan bluffs	86
path to dodge cemetary in a tree	dodge cemetery	86
in a tree at the ocean view foundation	cannon at legion park	86
path in front of water street inn	spring street	86
carey lot	long lot trail	86
under a bench across from town hall	fred benson town beach	86
the narragansett inn	the maze	86
hiking trail	elizabeth dickens trail	86
jetty across from the national in the rocks	the maze	86
rodmans hollow behind concrete sign	marsh hawk hollow	86
path to mohegan bluff overlook	attwood overlook	86
under cannon	cannon at legion park	86
the canon at the veterans' monument	cannon at legion park	86
winn dodge preserve	hodge family wildlife preserve	86
winfield dodge	win dodge	86
winfield dodge preserve	dodge cemetery	86
foundation at winn dodge	dodge cemetery	86
north end block island	north light	86
hole in manisses cemetery sign	dodge cemetery	86
"near bottom of ""lonely stairs"" in a wall near a tree with signs like: hogwarts, winterfell, etc. off beacon hill road"	block island chamber of commerce	86
under signage tree in the enchanted loop	enchanted forest	86
black rock weather station	black rock beach	86
old mill rd by horses in rock wall	black rock beach	86
dorie's cove	cow cove	86
hodge nature preserve	hodge preserve	86
"behind 'god bless usa"" sign at sit your butt or take a putt"	cannon at legion park	86
beach ave loop	block island state beach	86
maze trail	clay head trail	86
the hodge family preserve	hodge family wildlife preserve	86
across from the labyrinth	sacred labyrinth	86
inside cannon (baby size float)	baby beach	86
sunset beach	block island state beach	86
rodmans hollow short loop	harrison loop	86
nathan mott memorial park	legion park	86
at the labyrinth behind the painted rock in the sculpture garden. it was a rainy day.	black rock beach	86
near the pavilion	the maze	86
cannon base	cannon at legion park	86
fence line at strings and things	cannon at legion park	86
ocean ave	ocean view pavilion	86
pebble beach	block island state beach	86
playground at the school	the maze	86
stone wall in the old graveyard on corn neck rd	corn neck road	86
park near ferry boat dock	legion park	86
negus park	ball o' brien park	86
tree downtown off water street	spring street	86
in a tree habor church park	ball o' brien park	86
black rock parking lot	long lot trail	86
maze near laphams	the maze	86
in the stone wall along corn neck rd	corn neck road	86
surf hotel beach	baby beach	86
the daffodils	the maze	86
dinkel mazzur cemetery	dodge cemetery	86
under bridge on clayhead	dunn's bridge	86
bi bicycle tour qr #4	bi greenway	86
flower trail	elizabeth dickens trail	86
dickens farm trail	hyland trail	86
dickens rd under metal ring	dickens point	86
hodges nature preserve	hodge preserve	86
crabapple tree in front of harbor church	new harbor	86
overlook path off mohegan trial	attwood overlook	86
black sand trail	mott trail	86
legion hall cannon (took an hour to get out)	cannon at legion park	86
skate park	ball o' brien park	86
block island graveyard tree	island cemetery	86
bach trail	clay head trail	86
wind dodge reserve	win dodge	86
"dodge family preserve, stone foundation"	dodge cemetery	86
north dump beach	baby beach	86
near beach head	baby beach	86
in the canon	the maze	86
rock wall off lakeside drive.	black rock beach	86
walkway @ the bluffs	the maze	86
in the flower garden across the street from the national	spring street	86
geocaching at mansion in rock statue	black rock beach	86
cemetary next to the big tomb	the maze	86
robin hollow in meadow	meadow hill	86
hodge wildlife reserve	hodge preserve	86
clayhead and then catch and released on black rock	black rock beach	86
winfield preserve	hodge family wildlife preserve	86
rocks by the boat dock	the maze	86
legion hall cannon	legion park	86
rodman's trails	andy's way	86
loffredo preserve on top of birdhouse	hodge preserve	86
darius inn in the creeping hydrangea	the maze	86
block island club	block island chamber of commerce	86
fresh water preserve	fresh pond	86
center st. cemetery against a tombstone	dodge cemetery	86
overlook trail	elizabeth dickens trail	86
back seat of truck	block island chamber of commerce	86
center st. cemetery foot of tombstone	dodge cemetery	86
hodge entrance	hodge family wildlife preserve	86
american legion post 36	legion park	86
"bi nat. wildlife refuge, near labyrinth"	bi greenway	86
driftwood log at the entrance to ocean view	cannon at legion park	86
the legion hall cannon	legion park	86
clayhead trails off the main path	the maze	86
rodmans hollow stone wall	rodman hollow	86
mohegan bluff overlook	mohegan bluffs	86
end of dump road	block island chamber of commerce	86
enchanted forrest in a hollow tree	enchanted forest	86
bench at the tranfer station	the maze	86
salt water pond	fresh pond	86
inside giant drift tree on coast guard jeti	coast guard beach	86
beach ave trails	baby beach	86
town cemetery	fred benson town beach	86
path off old mill rd	old mill road	86
emily dickens	elizabeth dickens trail	86
lewis dickson reserve	lewis point	86
lewis dickens reserve sign in box	dickens point	86
emily dickens trail	hyland trail	86
coneymus ed in the wall	the maze	86
beach access path	baby beach	86
"coast guard cut, block island"	coast guard beach	86
ocean view foundation pavilion in a tree	ocean view pavilion	86
2nd bluffs path in tree	mohegan bluffs	86
old town road	fred benson town beach	86
motts park	ball o' brien park	86
trail off payne rd	hyland trail	86
cemetery- up in a tree!	dodge cemetery	86
negus park in a tree	legion park	86
trims pond trail	fresh pond	86
the indian cemetery momument	dodge cemetery	86
black rock in a lobster pot	black rock beach	86
"romans hollow, hidden in a bush!"	marsh hawk hollow	86
in hole of mantassean monumnet	snake hole road	86
mott farm trail	elizabeth dickens trail	86
in a hollow log on cooneymus	cooneymus beach	86
trail off payne rd.	hyland trail	86
the block island ferry boat	island cemetery	86
field off west side rd	west beach	86
sign at paynes overlook	payne overlook	86
green way off old mill rd	andy's way	86
trail to maze	elizabeth dickens trail	86
near farm	abrams animal farm	86
graces beach	block island state beach	86
old millard trail	mott trail	86
stairs on moghan bluffs	mohegan bluffs	86
the labyrinth	the maze	86
winfield dodge stonewall	dodge cemetery	86
ocean view on a memorial stone with compass setting.	ocean view pavilion	86
steps going down to moghean bluffs	mohegan bluffs	86
"clayhead, begining of the path in a fallen log"	the maze	86
boat basin beach	baby beach	86
end of mohegan bluff stairs in rock pile	black rock beach	86
black rock overlook in a stump	attwood overlook	86
on the bluffs at clayhead	mohegan bluffs	86
mohegian bluff overlook	payne overlook	86
graces cove pond	cow cove	86
way up in a tree	andy's way	86
the unenchanted forest	the maze	86
north side of clayhead trail!	clay head trail	87
base of the dunes on the beach at end of clayhead trail	clay head trail	87
gracie cove	grace's cove	87
on private trail headed to clayhead trail	clay head trail	87
long lots trail/clayhead trail	clay head trail	87
behind a rock on clayhead trail	clay head trail	87
beach at the end of clayhead trail	clay head trail	87
long lot connector to clayhead trail	clay head trail	87
in tree on clayhead trail	clay head trail	87
haunted forest	enchanted forest	87
driftwood near jetty at charleston beach	charlestown beach	87
in a tree along clayhead trail	clay head trail	87
roiles harbor beach off clayhead trail	clay head trail	87
under bridge on clayhead trail	clay head trail	87
in a rock wall on clayhead trail	clay head trail	87
in a tree stump on clayhead trail	clay head trail	87
on the beach off of clayhead trail	clay head trail	87
stone wall along clayhead trail	clay head trail	87
in a stonewall on a side trail in rodmans hollow	rodman's hollow	87
dinghey beach	dinhgy beach	88
dorrie's cove	dorry's cove	88
mohegan bluff sign	mohegan bluffs	88
barlow's pt.	barlow's point	88
artin's trail	martin trail	88
clay head trailside	clay head trail	88
rodman hallows	rodman hollow	89
clayhead trl	clay head trail	89
freeway trail	greenway trail	89
greenway across from rodman's at bench overlook	greenway	90
on a rock in the water off of spring street	spring street	90
greenway trail entrance lakeside druve	greenway	90
win dodge preserve	win dodge	90
clay head trail. in between a tree.	clay head trail	90
greenway trail on lakeside dr.	greenway	90
mohegan bluffs overlook	mohegan bluffs	90
greenway near bench	greenway	90
the maze behind stone wall!	the maze	90
the greenway between old mill road and cooneymus road in a wall behind a rock.	old mill road	90
greenway trail off beacon hill	beacon hill	90
"tree, near enchanted forest"	enchanted forest	90
rock wall off of fresh pond trail	fresh pond	90
on the hiking path near little sachem pond	sachem pond	90
near fresh pond in long stone wall adjacent to field	fresh pond	90
greenaway trail behind stone wall	greenaway	90
long lots/the maze	the maze	90
fresh pond behind wall at base of tree	fresh pond	90
beach across from beachhead (maybe baby beach)	baby beach	90
greenway north of beacon hill	beacon hill	90
side of trail on fresh pond trail	fresh pond	90
rock wall near fresh pond	fresh pond	90
fresh pond in grass	fresh pond	90
rodman's hollow-on the side of the jones trail	rodman's hollow	90
rodman's hollow in a tree	rodman's hollow	90
fresh pond preserve	fresh pond	90
rodman's hollow short loop	rodman's hollow	90
rodman hollow side of trail	rodman hollow	90
"rodman's hollow, near peckham farm"	rodman's hollow	90
entrance to rodman's hollow from fresh pond	fresh pond	90
fresh pond trail heading to rodman's hollow in a grouping of stones	fresh pond	90
rodman's hollow/jones trail	rodman's hollow	90
in the center of a tree on the greenway trail	greenway	90
rodman's hollow: fresh pond trail	fresh pond	90
rodman's hollow behind the bench.	rodman's hollow	90
fresh pond area	fresh pond	90
greenway/rodman's	greenway	90
pilot hill road & mohegan trail	mohegan trail	90
long lot trail @ long lot pond	long lot trail	90
meadow hill under rock	meadow hill	90
clayhead trail from corn neck road	corn neck road	90
the maze at clayhead	the maze	90
maze	the maze	90
nathan mott trail	mott trail	90
lobster pot in the maze	the maze	90
clayhead train / the maze	the maze	90
west beach trail	west beach	90
across from fresh pond	fresh pond	90
near north lighthouse	north light	90
payne's greenway	greenway	90
near the entrance of the fresh pond trail	fresh pond	90
fresh swamp payne farm trail	fresh swamp	90
mansion beach foundation	mansion beach	90
at the base of a bush on lewis dickens farm preserve	lewis-dickens farm	90
between scotch and mansion beach	mansion beach	90
"hodge preserve, in the bushes in circle part of trail"	hodge preserve	90
labyrinth	sacred labyrinth	90
rodman's hollow in the grass	rodman's hollow	90
harrison trail in a tree	harrison trail	90
lewis-dickens farm nature preserve	lewis-dickens farm	90
in a tree off of old mill road	old mill road	90
nestled between a piece of driftwood and sea grass at grace's cove	grace's cove	90
in a tree on turnip farm trail	turnip farm	90
trailhead on greenway near cooneymus	greenway	90
southeast lighthouse fence post	southeast light	90
greenway trail near turnip farm	greenway	90
fresh pond in stump	fresh pond	90
hodge preserve trail map stand	hodge preserve	90
beach avenue trail	beach avenue	90
"hodge preserve,in a tree"	hodge preserve	90
mohegan bluffs stairway	mohegan bluffs	90
west beach road	west beach	90
path near scotch beach	scotch beach	90
hodge preserve trailside	hodge preserve	90
"west beach, 50m north of the fence end in a hoary mugwort plant"	west beach	90
dickens trail	elizabeth dickens trail	90
fred benson town beach in the rocks	fred benson town beach	90
legion park in a tree	legion park	90
path to andy's way	andy's way	90
new harbor road bridge	new harbor	90
fence in front of hodge family wildlife preserve	hodge family wildlife preserve	90
greenaway by peter woods house	greenaway	90
crescent beach (across from oyster store)	crescent beach	90
andy's way path	andy's way	90
path to scotch beach	scotch beach	90
great salt pond near the channel	great salt pond	90
across the channel from the coast guard station	coast guard station	90
crescent beach between town and scotch	crescent beach	90
"island cemetery, next to a grave"	island cemetery	90
south side of center road on greenway trail	greenway	90
"hodge preserve ,in a tree"	hodge preserve	90
tree in harrison trail	harrison trail	90
tom's point under bench	tom's point	90
jetty rocks near crescent beach and ferry	crescent beach	90
entrance of path to scotch beach	scotch beach	90
the rona! harrison trail	harrison trail	90
sachem pond/ hodge family preserve rock wall	sachem pond	90
greenway trail near harrison loop	greenway	90
greenway next to beacon hollow farm off beacon hill road	beacon hill	90
community garden mosaic near ocean view pavilion	ocean view pavilion	90
"middle earth, inside a pile of rocks"	middle earth	90
in a tree. greenway trail that runs from payne to lakeside	greenway	90
meadow hill trail	meadow hill	90
"greenway trails, on the back side of a tree, in a hollowed out piece where another limb use to be"	greenway trail	90
beach at north light in driftwood	north light	90
small section of greenway trail off payne road.	greenway	90
meadow hill trail apple tree	meadow hill	90
in my bike helmet at scotch beach	scotch beach	90
beacon hill trail	beacon hill	90
beacon hill trail / enchanted forest in a tree trunk!	beacon hill	90
enchanted forest beacon hill	beacon hill	90
in between rocks at entrance to greenway trail	greenway	90
beacon hill and old milll trail	beacon hill	90
fresh swamp trail	fresh swamp	90
"o'brien park, little free library box"	library	90
harrison loop in a tree	harrison loop	90
enchanted forest in tree	enchanted forest	90
log wood cove (west side beach between north light and dump))	north light	90
rodman hollow/old mill trail in a rock wall	rodman hollow	90
on the floor of our jeep in the parking lot at nathan mott park	nathan mott park	90
center	visitor center	90
mansion beach parking area	mansion beach	90
"beacon hill rd., trail"	beacon hill	90
top of stairs at mohegan bluffs	mohegan bluffs	90
beacon hill greenway	beacon hill	90
greenway trail across from rodman's hollow	greenway	90
greenway trail off payne rd.	greenway	90
greenway trail. nathan mott park	greenway	90
old mill	old mill road	90
north light beach	north light	90
beacon hill road greenway	beacon hill	90
loffredo loop on trail to dodge cemetary	loffredo loop	90
greenway south beacon hill	beacon hill	90
enchanted forest old milll rd	enchanted forest	90
"loffredo loop, in the tall grass"	loffredo loop	90
in a clump of golden rod gaffney trail	gaffney trail	90
greenway between old mill road and dodge cemetery	dodge cemetery	90
"turnip farm, loffredo loop in a tree at sunset!"	loffredo loop	90
mohegan bluffs lookout trail	mohegan bluffs	90
"old mill road, in a bush"	old mill road	90
in a tree enchanted forest	enchanted forest	90
dickens farm	lewis-dickens farm	90
andy's way behind a log	andy's way	90
end of a fallen tree in the maze	the maze	90
dodge cemetery greenway	dodge cemetery	90
"nathan mott park trail, in large tree"	nathan mott park	90
"win dodge preserve, with gods blessing"	win dodge	90
the maze in a kalmia latifolia	the maze	90
in notch of trees on hyland trail	hyland trail	90
mansion beach access road	mansion beach	90
andy's way in the grass to the left once on beach	andy's way	90
nathan mott trail in a tree.	mott trail	90
walkway to scotch beach	scotch beach	90
long lot trail off corn neck	long lot trail	90
"rodman's hollow, in a tree!"	rodman's hollow	90
airport diner	airport	90
beach avenue bridge	beach avenue	90
cannon	cannon at legion park	90
"long lot, the maze"	the maze	90
fresh pond trail	fresh pond	90
"greenway off cooneymus rd, magellan's tree trail"	greenway	90
the maze in a pine tree	the maze	90
the maze in a tree	the maze	90
long lot trail @ mazewe were	long lot trail	90
long lot trail in a tree	long lot trail	90
old mill greenway	greenway	90
dorry's cove entryway	dorry's cove	90
somewhere in the maze...	the maze	90
dorry's cove grass	dorry's cove	90
rock wall in the maze	the maze	90
win dodge preserve behind tree in leaves	win dodge	90
path to baby beach	baby beach	90
win dodge preserve trail	win dodge	90
win dodge foundation trail under a tree in the brush	win dodge	90
the maze on clay head trail	clay head trail	90
"clay head trail in the maze, in tree"	clay head trail	90
"dorry's cove, next to a rock"	dorry's cove	90
rodman's hollow / on trail to old mill road	old mill road	90
"beach near crescent beach cottages, between scotch and mansion. we re-hid it."	crescent beach	90
scotch beach near crescent beach cottages	crescent beach	90
hanted forest	enchanted forest	90
mansion beach entrance walkway	mansion beach	90
new loop at clay head trail in a tree	clay head trail	90
clay head trail at maze entrance trail marker	clay head trail	90
cooneymus	cooneymus beach	90
"north light house beach, under/ behind a log"	north light	90
greenway trail across from fresh pond	fresh pond	90
entangled in fishermen's nets and rope on ballard's beach	ballard's beach	90
rock wall leading to greenway near rodman's hollow on cooneymus rd.	rodman's hollow	90
"grace's cove, under a rock cairn"	grace's cove	90
turn left on the hill on the mott trail.	mott trail	90
300 yards into greenway trail off beacon hill	beacon hill	90
mohegan trail walking path	mohegan trail	90
stone wall at andy's way	andy's way	90
beach avenue trail in a rock wall just off the trail	beach avenue	90
beacon hill rd greenway	beacon hill	90
nathan mott park (behind a rock in crevice)	nathan mott park	90
rodman's hollow rock wall y	rodman's hollow	90
clay head	clay head trail	90
hyland trail in drain pipe	hyland trail	90
andy's way beach	andy's way	90
long lot trail- stone wall	long lot trail	90
hollow	marsh hawk hollow	90
rodman's hollow bluffs lookout	rodman's hollow	90
rock wall in middle earth	middle earth	90
"greenway trail, uphill trail off of beacon hill rd."	beacon hill	90
found between old mill road trail on way to cemetery etary in a tree	old mill road	90
on the back side of stone wall at fresh pond (pumpkin float!)	fresh pond	90
clay head trail (pumpkin)	clay head trail	90
greenway lakeside drive	greenway	90
bluffs	mohegan bluffs	90
grace's cove beach	grace's cove	90
nathan mott park/ loredo loop	nathan mott park	90
end of hyland trail	hyland trail	90
end of coast guard beach under a log in a fort	coast guard beach	90
harrison loop trail between island cemetery and beacon hill rd	beacon hill	90
jim gaffney walk by fresh pond	fresh pond	90
greenway across from fresh pond	fresh pond	90
the maze (north of clay head trail) in a hollowed tree limb	clay head trail	90
west beach in a tire	west beach	90
rodman's hollow behind a trail sign	rodman's hollow	90
greenway trail by horse farm	greenway	90
vaill beach trail	vaill beach	90
end of win dodge in stone wall heading out to dickens farm road	win dodge	90
rodman hollow near black rock path	rodman hollow	90
jones trail rodman's hollow	rodman's hollow	90
fresh pond reserve	fresh pond	90
rothman's hollow	rodman's hollow	90
"trail off west side rd., heading into rodman's hollow"	rodman's hollow	90
fresh pond greenway	fresh pond	90
"rodman's hollow, at intersection of coastal trail"	rodman's hollow	90
jones trail in rodman's hollow	rodman's hollow	90
fresh pond greenway in depression in tree	fresh pond	90
rodman's hollow short loop at the base of a tree	rodman's hollow	90
n end of fresh pond	fresh pond	90
rodman hollow-jones trail	rodman hollow	90
greenway trail: in a stone wall	greenway	90
rock wall rodman's hollow	rodman's hollow	90
between vail beach and mohegan bluffs in the seaweed	mohegan bluffs	90
indian cemetary	'indian' cemetery	90
site of the spring street pump house plaque	spring street	90
mohegan trail/pilot hill intersection in a tree	mohegan trail	90
rodman's hollow trailhead	rodman's hollow	90
in wall at hodge preserve	hodge preserve	90
fresh pond rock wall	fresh pond	90
greenway trail off old mill road under the steps going over the rock wall	greenway trail	90
short trail off of beach avenue	beach avenue	90
drift wood coast guard beach	coast guard beach	90
592 old mill road trail	old mill road	90
meadow hill greenway	greenway	90
square stone wall in greenway off cooneymus rd	greenway	90
"win dodge, in tree by trail sign"	win dodge	90
greenway trail off of beacon hill rd	beacon hill	90
access path to scotch beach	scotch beach	90
sacred labrynth	sacred labyrinth	90
"greenway trail, 20 yards east of lakeside drive"	greenway	90
inside muffler at beach on west beach rd	west beach	90
nathan mott trail above the trail marker map	mott trail	90
entrance to payne farm trail	payne farm trail	90
black rock	black rock beach	90
on beach to the left off path from andy's way	andy's way	90
greenway trail off payne rd	greenway	90
near lewis-dickens farm sign	lewis-dickens farm	90
comings greenway	greenway	90
win dodge preserve (in rock wall near foundation)	win dodge	90
win dodge in the wall	win dodge	90
school	block island public school	90
win dodge presv.	win dodge	90
path to west beach (breed's lot)	west beach	90
trail off pilot hill road	pilot hill road	90
wedged in dune fencing at edge of second mohegan bluffs	mohegan bluffs	90
brick chimney on west beach	west beach	90
"west beach, northern section"	west beach	90
in stone wall on greenway off beacon hill rd.	beacon hill	90
marsh trail off beacon hill road	beacon hill	90
enchanted forest/old mill behind a tree	enchanted forest	90
crescent beach access- north of benson	crescent beach	90
enchanted forest (near beacon hill trail in hollowed out tree trunk)	beacon hill	90
mohegan bluffs overlook behind bike rack	mohegan bluffs	90
hyland trail deadend	hyland trail	90
state beach	block island state beach	90
meadow hill greenway trail	greenway	90
"wrack line, cow cove"	cow cove	90
turnip farm parking lot puddle	turnip farm	90
dingy beach in great salt pond	great salt pond	90
rodman's hollow by loop trail	rodman's hollow	90
our bike helmet at the fresh swamp trail- someone so kind left it for us!!!so	fresh swamp	90
in a tree on a walking path off beach avenue	beach avenue	90
sunfish at andy's way	andy's way	90
turnip farm trail off of old mill road	old mill road	90
greenway off of cooneymas	greenway	90
greenway trail off of lakeshore drive	greenway	90
"rodman's hollow, in a tree"	rodman's hollow	90
greenway trail between beacon hill rd. & old mill rd.	beacon hill	90
"jones trail, rodman's hollow"	rodman's hollow	90
mohegan bluffs stairs	mohegan bluffs	90
greenway trail fresh water pond in a stone wall crevice	greenway	90
circle of rocks on mansion beach	mansion beach	90
west beach in a chimney	west beach	90
grace's cove on top of the fort	grace's cove	90
trail across from fresh pond	fresh pond	90
the greenway off of beacon hill road	beacon hill	90
cooneymus beach next to waterfall	cooneymus beach	90
old mill rd greenway	greenway	90
in water hogpen new harbor	new harbor	90
crook of tree at mitchell farm	mitchell farm	90
drift wood tipi near north light	north light	90
rodman's hollow black rock beach overlook	black rock beach	90
sign at southeast lighthouse	southeast light	90
bike rack across from baby beach	baby beach	90
old mill road stone wall (greenway trail)	greenway	90
marsh trail off beacon hill	beacon hill	90
"dorry's cove, under seas grass and sticks"	dorry's cove	90
fresh pond behind a tree	fresh pond	90
north light upper path	north light	90
nathan mott park in hollowed out log	nathan mott park	90
win dodge rock wall	win dodge	90
behind rocks on harrison trail before middle earth	harrison trail	90
fresh pond preserve greenway	fresh pond	90
fresh pond canoe launch at waters bank in grass	fresh pond	90
greenway by fresh pond	fresh pond	90
hyland trail under tree near a stone wall covered with branches	hyland trail	90
hyland trail in a tree	hyland trail	90
loffredo loop...in the branches of the big beautiful tree :)	loffredo loop	90
behind rock wall on the maze trail	the maze	90
rodman's hollow stuck in a tree on the rough road	rodman's hollow	90
"the maze, behind a small tree"	the maze	90
nathan mott park on 7/29	nathan mott park	90
"the maze, in a rock wall"	the maze	90
"the maze, in a giant rhododendron bush"	the maze	90
greenway trail. will rehide #95	greenway	90
by the water bottle refill station on corn neck road	corn neck road	90
nathan mott park (big tree)	nathan mott park	90
hodge	hodge family wildlife preserve	90
spring street gallery	spring street	90
logwood cove- in a log	logwood cove	90
on the beach at the north lighthouse	north light	90
meadow greenway	greenway	90
short trail off of mohegan trail	mohegan trail	90
enchanted forest behind a rock wall	enchanted forest	90
turnip farm behind small road sign at an intersection	turnip farm	90
scotch beach- last beach access	scotch beach	90
west of north light	north light	90
fresh swamp trail- in tree branches	fresh swamp	90
john r. dodge cemetery	dodge cemetery	90
tree by fresh pond	fresh pond	90
grace's cove beach under a log (had to dig a little)	grace's cove	90
harrison trail in tree near west side rd	harrison trail	90
crescent beach walkover	crescent beach	90
mohegan bluffs under bench	mohegan bluffs	90
pilot hill	pilot hill road	90
in grass behind the turnip farm sign	turnip farm	90
greenway path off of old mill rd	greenway	90
in tree off airport trail	airport	90
"rodman's hollow, in a pine tree trunk"	rodman's hollow	90
"long lot trail, somewhere in the maze"	long lot trail	90
harrison trail before middle earth in tree notch	harrison trail	90
marsh hawk hollow in a tree stump	marsh hawk hollow	90
greenway trail off of cooneymus	greenway	90
"under a log, greenway, beacon hill"	beacon hill	90
rocks by bike rack at the top of the mohegan bluffs	mohegan bluffs	90
rodman's hollows in tree	rodman's hollow	90
rodman's hollow in a dead tree stump	rodman's hollow	90
american legion park	legion park	90
tree	spring street	90
airport greenway trail	airport	90
tree stump mansion beach parking lot	mansion beach	90
just off trail that turns right near rodman hollow parking lot	rodman hollow	90
fresh pond overlook	fresh pond	90
greenway off old mill road	greenway	90
greenway-fresh swamp trail	fresh swamp	90
greenway trail off old mill road in a tree	greenway	90
greenway trail old mill	greenway	90
under a rock below middle earth sign	middle earth	90
greenway trail (off lakeside dr)	greenway	90
nathan mott greenway- stonewall	greenway	90
cooneymus beach behind a huge rock	cooneymus beach	90
"rodman's hollow,on ground...1/4 mi. from entrance"	rodman's hollow	90
greenway trail off old mill	greenway	90
greenway south off old mill rd	greenway	90
under bench at end of pilot hill road	pilot hill road	90
nathan mott park in a tree!	nathan mott park	90
behind tree rodman's hollow short loop	rodman's hollow	90
greenway trail by airport	airport	90
beacon hill road greenway trail	beacon hill	90
beacon hill doc willis's stone wall	beacon hill	90
harrison loop in the base of a tree	harrison loop	90
rodman hollow trail map case	rodman hollow	90
fresh pond trails	fresh pond	90
path off of old mill road	old mill road	90
on clay head trail in tall grass near the north end of the trail	clay head trail	90
rodman's hollow long loop	rodman's hollow	90
"beacon hill greenway trail, in a stone wall"	beacon hill	90
off of old mill rd on greenway trail	greenway	90
fresh pond in a tree	fresh pond	90
snake hole	snake hole road	90
"nathan mott park, stone wall"	nathan mott park	90
the hodge greenway trail	greenway	90
fresh pond tree	fresh pond	90
airport trail- hidden in a stump	airport	90
mott trail system	mott trail	90
cemetery	dodge cemetery	90
sign tree in nathan mott park	nathan mott park	90
airport (in bushes)	airport	90
loffredo loop on my birthday!!	loffredo loop	90
"wedged between tree trunks at turnip farm on lofferdo loop and westside rd,"	turnip farm	90
ct ave greenway trail	greenway	90
tree notch near middle earth	middle earth	90
payne farm/ fresh swamp	fresh swamp	90
greenway spur near beacon hill	beacon hill	90
fresh pond tree near cemetery	fresh pond	90
greenway trail off old mill rd	greenway	90
in freshly cut grass at fresh pond	fresh pond	90
"payne road greenway, buried in the grass behind a trail marker sign"	payne road greenway	90
path in rodman's hollow	rodman's hollow	90
trail to north lighthouse	north light	90
stone wall on lakeside dr just before the fresh pond view trail head	fresh pond	90
greenway trail off ct ave.	greenway	90
path to north light	north light	90
greenway-fresh swamp	fresh swamp	90
tree on harrison trail before middle earth	harrison trail	90
end of rodman's hollow trail at black rock point in a hold under a rock	rodman's hollow	90
marsh hawk hollow in stone wall	marsh hawk hollow	90
nathan mott trail stone wallcorner	mott trail	90
greenway trail off payne road	greenway	90
greenway trail (tree stump)	greenway	90
greenway trail entrance on payne's rd.	greenway	90
"elizabeth dickens trail in a pricker bush, halloween day , 2017"	elizabeth dickens trail	90
"elizabeth dickens trail, sw- in clump of tall grass"	elizabeth dickens trail	90
"win dodge preserve, tree, near entrance"	win dodge	90
spring street gallery in the tree poetry box	spring street	90
greenway trail on old mill road in a tree just past entrance.	greenway	90
champlin rd beach before the coast guard station	coast guard station	90
greenway trail enchanted forest	enchanted forest	90
enchanted forest path in branches up high	enchanted forest	90
beacon hill greenway trail	beacon hill	90
"rodman's hollow, heading towards fresh pond"	fresh pond	90
shoreline just e. of settler's rock	settler's rock	90
beginning of greenway: enchanted forest	enchanted forest	90
nathan mott greenway	greenway	90
greenway trail off cooneymus rd.	greenway	90
enchanted forest in an old log	enchanted forest	90
head of nathan mott trail	mott trail	90
win-dodge in a tree	win dodge	90
"the maze, inside cedar tree"	the maze	90
"the maze, at base of tree"	the maze	90
"library, front yard"	library	90
"enchanted forest, inside tree trunk at a dead end"	enchanted forest	90
clay head trail in a tree	clay head trail	90
dorry's cove-by driftwood	dorry's cove	90
greenway between old mill and cooneymus	greenway	90
"harrison trail at west side road, in stone wall"	harrison trail	90
fresh pond trail off of rodman's hollow in large tree at path intersection	fresh pond	90
under some trail shrubbery at an intersection somewhere between enchanted forest and turnip farm	enchanted forest	90
inside tree-greenway	greenway	90
beach ave greenway trail	greenway	90
greenway trail between payne rd and westshore rd. found under small bridge	greenway trail	90
rocks mansion beach foundation	mansion beach	90
mansion beach by rocks	mansion beach	90
peter woods greenway park in tree	greenway	90
on side road under a hollow of a tree leading into the maze	the maze	90
settler's rock shoreline	settler's rock	90
trail at the fresh pond preserve	fresh pond	90
greenway off lakeside dr.	greenway	90
sea grass mohegan bluffs	mohegan bluffs	90
fresh swamp by payne rd	fresh swamp	90
bridge near mansion beach	mansion beach	90
mohegan bluffs lobster trap	mohegan bluffs	90
greenaway path old town road	greenaway	90
walkers welcome path mohegan trail	mohegan trail	90
cooneymus beach under a log crossing the freshwater stream/waterfall	cooneymus beach	90
trail to fresh pond preserve	fresh pond	90
meadow greenway trail	greenway	90
to the right of nathan mott (enchanted forest) trail in a stonewall	enchanted forest	90
scotch	scotch beach	90
win-dodge presrve	win dodge	90
southside beacon hill road greenway trail	beacon hill	90
gift: cooneymus beach in a bush	cooneymus beach	90
stairs to the sacred labyrinth	sacred labyrinth	90
under a loose board on clay head trail	clay head trail	90
inside the barrel of the cannon at legion park	cannon at legion park	90
fred benson town beach among some rocks	fred benson town beach	90
"west beach, block island"	west beach	90
west beach near north point	west beach	90
greenway off cooneymus	greenway	90
dump beach walking toward beane point	beane point	90
on the rocks at scotch beach	scotch beach	90
on the beach behind a large rock near mansion beach road and the crescent cottages	mansion beach	90
hodge preserve- corn neck rd.	hodge preserve	90
john dodge cemetery road	dodge cemetery	90
"end of breakwater, entrance into great salt pond"	great salt pond	90
greenway across from fresh pond on lakeside dr.	fresh pond	90
stone wall near fresh pond	fresh pond	90
fresh pond trail up in tree	fresh pond	90
greenway off payne rd.	greenway	90
beach avenue trail stone walll	beach avenue	90
loffredo loop : beginning of trail in a tree crevice	loffredo loop	90
ocean view	ocean view pavilion	90
enchanted forest beacon hill trail	beacon hill	90
in the field near the beginning of the fresh swamp trail	fresh swamp	90
mott trail head	mott trail	90
rodman's hollow in brush under a pine tree	rodman's hollow	90
rodman's hollow under a tree	rodman's hollow	90
beach on the great salt pond behind aka house	great salt pond	90
stump on harrison trail	harrison trail	90
greenway between beacon hill road and west side road	beacon hill	90
fresh pond under a large rock	fresh pond	90
win dodge reserve	win dodge	90
turnip farm greenway	greenway	90
wedged in a tree in the turnip farm	turnip farm	90
"greenway off lakeside drive, opposite fresh pond"	fresh pond	90
corn neck rd in stone wall near beautiful tree by mitchell farm	mitchell farm	90
peckham farm / fresh pond trail	fresh pond	90
great salt pond under walkeay	great salt pond	90
path to fresh pond from rodman's hollow	fresh pond	90
greenway trail (west side of bi)	greenway	90
mott trail in a maple tree	mott trail	90
trails between beacon hill rd and old mill rd	beacon hill	90
legion park- farmers market	legion park	90
mansion beach foundations	mansion beach	90
path across from big red barn on beacon hill rd	beacon hill	90
side of greenway trail at the end of snake hole road. sadly broken!	greenway trail	90
fork in fresh swamp trail	fresh swamp	90
walking trail between cooneyymus and old mill road	old mill road	90
stonewall at end of hodge preserve	hodge preserve	90
fresh pond loop	fresh pond	90
path to cooneymus beach	cooneymus beach	90
1/2 mile north of benson beach on corn neck road	corn neck road	90
"north mouth of the great salt pond, donated to rita at the 1661 inn, you can see it there!"	great salt pond	90
greenway trail off old mill road	greenway	90
gaffney trail/in tall grass by white fense	gaffney trail	90
rock wall on service rd b/t corn neck rd and north end of clay head trail	clay head trail	90
"gaffney trail, top of rock wall past bee hives"	gaffney trail	90
brick wall on corn neck road	corn neck road	90
enchanted forest (found june 2017)	enchanted forest	90
near turnip farm/ hiking trail off old mill rd	turnip farm	90
along shoreline of hodge family wildlife preserve	hodge family wildlife preserve	90
stink stack of outhouse by southeast light house	southeast light	90
turnip farm trail	turnip farm	90
beginning of nathan mott trail	mott trail	90
clay head trail in brush past beach access	clay head trail	90
bottom fork of tree on greenways path	greenway	90
mitchell farm rock fence on corn neck road	corn neck road	90
middle of fresh pond trail	fresh pond	90
near fresh pond monument	fresh pond	90
stone wall on path to rodmans hollow from old mill road	old mill road	90
stone wall at peckham pond	peckham pond	90
enchanted forest on old mill rd	enchanted forest	90
right side of north light on beach	north light	90
by beach access to baby beach	baby beach	90
entrance to southeast lighthouse	southeast light	90
parking lot of the mohegan bluffs	mohegan bluffs	90
in a plant in front of library	library	90
the putting green near mohegan bluffs in one of the holes	mohegan bluffs	90
attwood overlook in a bush	attwood overlook	90
lakeside greenway trail	greenway	90
stone wall on greenway trail off of payne road	greenway	90
greenway trail off of west side rd.	greenway	90
black rock rd near tom's point	tom's point	90
under a bush in rodman's hollow	rodman's hollow	90
between dories cove and cooneymus beach	cooneymus beach	90
on ground by path at rodman's hollow thanksgiving 2016	rodman's hollow	90
enchanted	enchanted forest	90
harrison loop in tree stump	harrison loop	90
tree branch harrison loop	harrison loop	90
harrison trail between west side road and beacon hill	beacon hill	90
trail near turnip farm	turnip farm	90
under rope at north lighthouse beach	north light	90
coast guard beach in a hollow log	coast guard beach	90
north light house	north light	90
enchanted forest : small side trail up a hill next to stone wall	enchanted forest	90
north light beach in a tall upright piece of driftwood	north light	90
north light house at very tip or beach between 2 logs	north light	90
little free library @ the skate park	library	90
manisseans monument stone across from fresh pond	fresh pond	90
path to north lighthouse in grasses	north light	90
behind driftwood on north lighthouse beach	north light	90
north lighthouse beach	north light	90
great salt pond to beacon hill	beacon hill	90
water line west of north light right of settlers rock	north light	90
block island's mansion beach	mansion beach	90
pavilion	ocean view pavilion	90
town beach	charlestown beach	90
lewis dickens farm preserve	lewis-dickens farm	90
hodge preserve in a tree down by middle pond	hodge preserve	90
hodge preserve parking area	hodge preserve	90
clay head trail overlook	clay head trail	90
rodman's hollow side trail	rodman's hollow	90
payne road greenway in tall grass	greenway	90
old mill greenway trail next to stone wall	greenway	90
near fresh pond	fresh pond	90
hole in wall by mansion beach parking lot	mansion beach	90
greenway entrance old mill rd.	greenway	90
jim gaffney greenway	greenway	90
greenway between old mill and beacon hill	beacon hill	90
hodge greenway	greenway	90
"next to compost bin, public gardens atop hill in new shoreham"	new shoreham	90
tire on west beach	west beach	90
greenway trail crossing cooneymus rd	greenway	90
art installation at hodge preserve	hodge preserve	90
greenway trail off beacon hill in a rock wall	beacon hill	90
connecting trail between black rock and long loop in rodman's hollow	rodman's hollow	90
greenway by p.woods	greenway	90
old mill road trail to rodmans hollow eye level in branches!	old mill road	90
mansion	mansion beach	90
entering rodman's west of fresh pond	fresh pond	90
greenway trail in a small tree	greenway	90
greenway trail off of beacon hill	beacon hill	90
rodmens hollow	rodman's hollow	90
"the greenway, center rd"	greenway	90
clay head trail at the beach entrance	clay head trail	90
in the bushes at a rodman's hollow overlook	rodman's hollow	90
nathan mott park trail under a rock	nathan mott park	90
"behind north light sign, in a plant"	north light	90
greenway beach road	greenway	90
nathan mott park & turnip farm	nathan mott park	90
greenway near street	greenway	90
park	ball o' brien park	90
beach avenue traik	beach avenue	90
blue stone at clay head trail	clay head trail	90
beach at clay head trail	clay head trail	90
clay head trail (under footbridge)	clay head trail	90
fresh swamp and payne farm trail	fresh swamp	90
next to rock on greenway	greenway	90
fresh swamp & payne farm trail	fresh swamp	90
ocean view pavilion inside ornamental grass bush	ocean view pavilion	90
hodge preserve near fence post	hodge preserve	90
the cannon where the farmer's market is	farmer's market	90
"spring street, 'art garden' near bench under tree"	spring street	90
chamber of commerce	block island chamber of commerce	90
old mill road greenway trail	greenway	90
clayhead traik	clay head trail	90
"on beach, southeast of little sachem pond under a mesh screen"	sachem pond	90
marsh hawk hollow in center of tree stump	marsh hawk hollow	90
marsh hawk hollow up in a tree	marsh hawk hollow	90
in tree on greenway trails	greenway	90
greenway trail old town rd	greenway	90
beach ave greenway trail on ground under grass	greenway	90
greenway trail #3 in a stump	greenway	90
high meadow greenway	greenway	90
northern lights poem box at a cow cove	cow cove	90
under tree deep in the grass fresh pond trail	fresh pond	90
beach ave greenway	greenway	90
greenway off beacon hill rd.	beacon hill	90
in a potted christmas catus in airport lobby	airport	90
greenway trails by payne rd	greenway	90
the greenway greenway trail	greenway	90
"hollow log, walking south from west beach rd"	west beach	90
windodge greenway	greenway	90
greenway trail in tuft of tall grass	greenway	90
lake side dr across from fresh pond	fresh pond	90
in a tree of on the greenway off of conneymus road	greenway	90
rodman hollow side trail	rodman hollow	90
greenway trail (lakeside drive)	greenway	90
"gaffney greenway, on a stump"	greenway	90
greenway off old mill rd in crook of tree	greenway	90
nathan mott park/enchanted forest	enchanted forest	90
old mill side trail going into rodman's hollow under grass	rodman's hollow	90
in the flower boxes outside of the post office	post office	90
greenway trail off old mill in the brush near a rock wall	greenway	90
hollowed out tree stump meadow hill	meadow hill	90
greenway on old mill road under brush	greenway	90
in a tree @ old mill greenway	greenway	90
enchanted forest entrance on old mill road in a tree	enchanted forest	90
southeast lighthouse overlook	southeast light	90
elizabeth dickens trailhead at dicken's road	elizabeth dickens trail	90
behind rock sign for north lighthouse beach	north light	90
near north light trail parking	north light	90
legion park canon	legion park	90
great salt pond across from coast guard beach	coast guard beach	90
"enchanted forest, near year-round pond"	enchanted forest	90
"harrison loop, in the nook of a tree."	harrison loop	90
clay head trail tucked in vines	clay head trail	90
mott park area / airport	airport	90
nature's nobleman greenway	greenway	90
near airport	airport	90
rodman's hollow in some rocks	rodman's hollow	90
in the canon legion park	legion park	90
mott trail near bench	mott trail	90
greenaway in grasses	greenaway	90
greenway trail off beach ave	greenway	90
rodman's hollow behind stone marker	rodman's hollow	90
greenway path off beacon hill rd	beacon hill	90
in rock wall on cooneymus greenaway trail	greenaway	90
enchanted forest cart way	enchanted forest	90
turnip farm greenway entrance in rocks	greenway	90
off old mill rd greenway	greenway	90
rodman's hollow-loop by black rock	rodman's hollow	90
greenway close to cooneymus road	greenway	90
enchanted forest in hollowed out tree	enchanted forest	90
greenway trail near fresh pond	fresh pond	90
meadow hill trail in a tree covered in vines	meadow hill	90
fresh swamp trail in stone wall!	fresh swamp	90
snake hole road at entrance to beach access	snake hole road	90
hodge preserve behind the stone trail marker	hodge preserve	90
cooneymus beach in a lobster trap	cooneymus beach	90
cooneymus beach hidden in log wall	cooneymus beach	90
beach avenue trails	beach avenue	90
west beach by north light	north light	90
beach in front of north light in a pile of rocks	north light	90
southeast lighthouse tower window sill	southeast light	90
on the beach just in front of the north lighthouse.	north light	90
east bank of sachem pond	sachem pond	90
overlook to fresh pond on lakeside drive	fresh pond	90
"attwood overlook, next to a tree."	attwood overlook	90
the trail leading to andy's way	andy's way	90
greenway of cooneymus road	greenway	90
greenway off cooneymus road	greenway	90
coast guard station trail to breakwater new harbor	coast guard station	90
greenway trails-wooden box near beacon hill	beacon hill	90
greenway trails beacon hill rd in thicket of bush	beacon hill	90
under bush at entrance to middle pond @ hodge preserve	hodge preserve	90
fresh swamp walking trail	fresh swamp	90
cemetery by fresh pond	fresh pond	90
scotch beach entrance	scotch beach	90
mansion beach tied up in a sack in a tree	mansion beach	90
west beach under rim	west beach	90
mott park (close to airport)	airport	90
tree at fresh pond	fresh pond	90
scotch beach trail	scotch beach	90
scotch beach access path	scotch beach	90
"beach avenue greenway, in the brush by the stone wall at trims pond"	beach avenue	90
under bridge at fresh pond	fresh pond	90
fresh pond under tree roots	fresh pond	90
west beach-breed property	west beach	90
fresh pond trail under the shrubs near the pond	fresh pond	90
floating in fresh pond	fresh pond	90
crescent beach trail from corn neck rd	crescent beach	90
first path on right going towards mohegan bluffs	mohegan bluffs	90
wlkers welcome path off mohegan trail	mohegan trail	90
greenway trail meadow hill	greenway	90
"west beach, south of west beach road, under large driftwood"	west beach	90
north of mansion beach	mansion beach	90
greenway trail off of old mill rd. next to the horse farm. beneath weeds wrapped around a tree.	greenway trail	90
"west beach, west of middle pond under large driftwood 06/04/2015"	west beach	90
trail by north light	north light	90
on a greenway in a tree	greenway	90
old town road greenway	greenway	90
under rock at rodman's hollow parking area	rodman's hollow	90
rock wall at the martin property	martin property	90
"turnip farm greenway entrance, to the left of the gate behind a rock"	turnip farm	90
turnip farm in a bush	turnip farm	90
"enchanted forest, old mill side, in a tree"	enchanted forest	90
rock wall on clay head trail	clay head trail	90
"the maze, in a tree. not sure exactly where, as it was night."	the maze	90
"in a tree, turnip farm"	turnip farm	90
enchanted forest in the base of a tree clump	enchanted forest	90
rodmans hallow	rodman's hollow	90
on the path of clay head trail	clay head trail	90
harrison trail; hidden in a tree	harrison trail	90
in the sand on west beach	west beach	90
greenway off of beacon hill road. in a rock.	beacon hill	90
across from airport	airport	90
turnip farm area stone wall	turnip farm	90
next to the enchanted forest resting inside a tree	enchanted forest	90
stonewall near middle earth on greenway trail	greenway	90
greenway path off of cooneynus	greenway	90
rodmans hollow turnip farm in a broken tree stump.	turnip farm	90
"trail south of peter woods, old mill road"	old mill road	90
greenway trail off cooneymus	greenway	90
behind peter woods off old mill road	old mill road	90
"cooneymus beach, in a driftwood log hollow, covered with sand"	cooneymus beach	90
cooneymus beach in plastic container	cooneymus beach	90
cooneymus beach/ dory's cove in driftwood log	cooneymus beach	90
"mohegan bluffs, in lobster trap"	mohegan bluffs	90
beacon hill greenway area	beacon hill	90
southeast	southeast light	90
west beach near north lighthouse.	north light	90
half-buried in sand near the north lighthouse	north light	90
south of grace's cove entrance	grace's cove	90
rock wall foundation of the win dodge preserve	win dodge	90
between schooner point and dickens point in lobster pot	dickens point	90
"on the beach below mohegan bluffs-- against a rock, partiallly buried in clay"	mohegan bluffs	90
greenway harrison loop	greenway	90
harrison trail in tree	harrison trail	90
in the enchanted forest to the left of the enchanted forest sign in a rock wall	enchanted forest	90
north light beach buried in sand	north light	90
"enchanted forest, hilltop rock wall"	enchanted forest	90
"enchanted forest, on ground among downed,cleared branches"	enchanted forest	90
in tidal debris north of the old cut on the great salt pond	great salt pond	90
clay head trail entrance to beach.	clay head trail	90
beacon hill greenway- in an tree stump	beacon hill	90
mansion beach in the foundation of the mansion	mansion beach	90
"northwest beach, south of north light"	north light	90
on sand of west beach	west beach	90
sign at mohegan bluffs	mohegan bluffs	90
"clay head trail, base of tree"	clay head trail	90
"clay head trail, in a dead tree"	clay head trail	90
inside engine block on west beach	west beach	90
old harbor	old harbor point	90
north light house beach	north light	90
island free library in a flower pot	library	90
great salt pond south of bi club	great salt pond	90
between surf beach and town beach	surf beach	90
"southeast lighthouse, outside on the windowsill by the ramp"	southeast light	90
charlestown beach inside driftwood log	charlestown beach	90
marsh by andy's way	andy's way	90
beach heading to north light	north light	90
airport/mott trail	airport	90
"mohegan bluffs -- in a tree; found on may 23, 2014"	mohegan bluffs	90
rock wall at mansion beach	mansion beach	90
on a boulder on a greenway trail near black rock beach	black rock beach	90
bluff above black rock beach	black rock beach	90
"mosquito beach, washed ashore"	mosquito beach	90
enchanted forest behind a rock	enchanted forest	90
dorry's cove-in a bleach bottle	dorry's cove	90
greenway trail in tree near cooneymus rd	greenway	90
"off enchanted forest path, taking a left at the top of the hill, under a tree."	enchanted forest	90
inside lobster trap on dorry's cove beach	dorry's cove	90
west beach on a rusty tire rim	west beach	90
enchanted forest in wall at entrance	enchanted forest	90
west beach/ dump road	west beach	90
"west beach, near north light"	north light	90
"west beach, close to north light"	north light	90
south of the north light west beach side	north light	90
in a tree in the enchanted forest	enchanted forest	90
greenway trail airport	airport	90
near turnip farm on greenway	greenway	90
turnip farm entrance	turnip farm	90
mansion beach under rock pile	mansion beach	90
entrance to mansion beach	mansion beach	90
southwest point beach/ cooneymus rd	southwest point	90
dory cove beach	dorry's cove beach	91
beans point	beane point	91
hodge's wildlife preserve	hodge family wildlife preserve	91
leffredo loop	loffredo loop	92
lofreddo loop	loffredo loop	92
dinghy beach	dinhgy beach	92
rodman hallow	rodman hollow	92
gracies cove	grace's cove	92
rodman jollow	rodman hollow	92
old mill rd	old mill road	92
massion beach	mansion beach	92
gracy's cove	grace's cove	92
corn neck rd	corn neck road	92
dodge preserve	hodge preserve	93
mohegan bluffe	mohegan bluffs	93
rodman's hallow	rodman's hollow	93
island cemetary	island cemetery	93
rodman's holkow	rodman's hollow	93
conneymus beach	cooneymus beach	93
dodge cemetary	dodge cemetery	93
clayead trail	clay head trail	93
southeast point	southwest point	93
romans hollow	rodman's hollow	93
snake hole rd.	snake hole road	93
greenaway trails	greenway trail	93
snake hole rd	snake hole road	93
payne rd greenway	payne road greenway	94
windodge	win dodge	94
greenways	greenway	94
marsh hawk hallow	marsh hawk hollow	94
scotch beach path	scotch beach	95
greenway off of payne road	payne road greenway	95
nathan mott	nathan mott park	95
the sacred labyrinth	sacred labyrinth	95
cannon @ legion park	cannon at legion park	95
payne's overlook	payne overlook	95
spring pond area	spring pond	95
grace cove	grace's cove	95
john dodge cemetery	dodge cemetery	95
ocean pavilion	ocean view pavilion	95
hodge family preserve	hodge family wildlife preserve	95
lewis dickens farm trail	lewis-dickens farm	95
pilot hill road pond	pilot hill road	95
wind dodge cemetery	dodge cemetery	95
southwest point beach	southwest point	95
end of elizabeth dickens trail	elizabeth dickens trail	95
fred benson beach	fred benson town beach	95
grass coast guard beach	coast guard beach	95
ballard's beach jetty	ballard's beach	95
old mill road path	old mill road	95
vail beach	vaill beach	95
hodge preserve pond	hodge preserve	95
marsh hollow	marsh hawk hollow	95
dunn bridge	dunn's bridge	95
the hyland trail	hyland trail	95
visitor center atm	visitor center	95
great salt pond coast	great salt pond	95
hodge wildlife preserve	hodge family wildlife preserve	95
path to coast guard beach	coast guard beach	95
block island cemetery	island cemetery	95
nathan mott park trail	nathan mott park	95
block island school	block island public school	95
coast guard beach walkway	coast guard beach	95
enchanted forest bi	enchanted forest	95
marsh hawk hollow trail	marsh hawk hollow	95
fresh pound	fresh pond	95
lewis-dickens farm trail	lewis-dickens farm	95
winn dodge	win dodge	95
southeast light house	southeast light	95
ocean view pavilion trail	ocean view pavilion	95
lewis dickenson farm	lewis-dickens farm	95
martin's trail	martin trail	95
clay head trail beach	clay head trail	95
lewis-dickens farm trial	lewis-dickens farm	95
settler's rock beach	settler's rock	95
elizabeth dickens	elizabeth dickens trail	95
andys way	andy's way	95
rodman's hollow bench	rodman's hollow	95
in the cannon at legion park	cannon at legion park	95
hodge family wildlife preserve stone wall	hodge family wildlife preserve	95
payne road greenway broken	payne road greenway	95
greenway trail fp	greenway trail	95
the post office	post office	95
oceanview pavillion	ocean view pavilion	95
clay head hill trail	clay head trail	95
hodge preserve trail	hodge preserve	95
lewis dickens	lewis-dickens farm	95
harrison's loop	harrison loop	95
off old mill road	old mill road	95
near harrison loop	harrison loop	95
motts trail	mott trail	95
dunn's bridge path	dunn's bridge	95
ocean view pavilion (rafters)	ocean view pavilion	95
payne greenway	payne road greenway	95
grace's cove pond	grace's cove	95
mohegan bluffs beach	mohegan bluffs	95
coast guard channel beach	coast guard beach	95
martins trail	martin trail	96
martin trails	martin trail	96
longwood cove	logwood cove	96
meadow hills	meadow hill	96
dory's cove	dorry's cove	96
mohegan bluff	mohegan bluffs	96
graces cove	grace's cove	96
dingy beach	dinhgy beach	96
dorrys cove	dorry's cove	96
dicken's point	dickens point	96
gafney trail	gaffney trail	96
settlers rock	settler's rock	96
gracie's cove	grace's cove	96
turnip farms	turnip farm	96
dorrey's cove	dorry's cove	96
roadman's hollow	rodman's hollow	97
atwood overlook	attwood overlook	97
clayhead trail	clay head trail	97
rodmans hollow	rodman's hollow	97
enchanted forrest	enchanted forest	97
ball o'brien park	ball o' brien park	97
indian cemetery	'indian' cemetery	97
coastguard beach	coast guard beach	97
clay head trails	clay head trail	97
green way trail	greenway trail	97
charleston beach	charlestown beach	97
rodman's holow	rodman's hollow	97
ocean view pavillion	ocean view pavilion	97
dodge family wildlife preserve	hodge family wildlife preserve	97
dory's cove beach	dorry's cove beach	97
abrams' animal farm	abrams animal farm	97
farmers market	farmer's market	97
greenway trails	greenway trail	97
greenaway trail	greenway trail	97
hodge family wildlife reserve	hodge family wildlife preserve	98
hyland trail	hyland trail	100
fresh swamp	fresh swamp	100
the maze	the maze	100
turnip farm	turnip farm	100
loffredo loop	loffredo loop	100
rodman's hollow	rodman's hollow	100
fresh pond	fresh pond	100
fresh pond!	fresh pond	100
meadow hill	meadow hill	100
nathan mott park	nathan mott park	100
enchanted forest	enchanted forest	100
win dodge	win dodge	100
hodge family wildlife preserve	hodge family wildlife preserve	100
dodge cemetery	dodge cemetery	100
clay head trail	clay head trail	100
visitor center	visitor center	100
trim's pond	trim's pond	100
harrison loop	harrison loop	100
marsh hawk hollow	marsh hawk hollow	100
great salt pond	great salt pond	100
old mill road	old mill road	100
cannon at legion park	cannon at legion park	100
fire department	fire department	100
mohegan bluffs	mohegan bluffs	100
scotch beach	scotch beach	100
west beach	west beach	100
greenway trail	greenway trail	100
elizabeth dickens trail	elizabeth dickens trail	100
greenway	greenway	100
martin trail	martin trail	100
grace's cove	grace's cove	100
gaffney trail	gaffney trail	100
long lot trail	long lot trail	100
north light	north light	100
sachem pond	sachem pond	100
andy's way	andy's way	100
sacred labyrinth	sacred labyrinth	100
legion park	legion park	100
pilot hill road	pilot hill road	100
mansion beach	mansion beach	100
island cemetery	island cemetery	100
dorry's cove	dorry's cove	100
payne farm trail	payne farm trail	100
coast guard beach	coast guard beach	100
payne road greenway	payne road greenway	100
lewis dickens farm	lewis-dickens farm	100
beane point	beane point	100
attwood overlook	attwood overlook	100
rodman hollow	rodman hollow	100
mosquito beach	mosquito beach	100
beacon hill	beacon hill	100
block island historical society	block island historical society	100
harrison trail	harrison trail	100
middle earth	middle earth	100
dickens point	dickens point	100
jim gaffney trail	jim gaffney trail	100
fred benson town beach	fred benson town beach	100
baby beach	baby beach	100
hodge preserve	hodge preserve	100
southwest point	southwest point	100
hodge property	hodge property	100
middle earth (??)	middle earth	100
ocean view pavilion	ocean view pavilion	100
cooneymus beach	cooneymus beach	100
post office	post office	100
middle earth(??)	middle earth	100
farmer's market	farmer's market	100
charlestown beach	charlestown beach	100
mott trail	mott trail	100
crescent beach	crescent beach	100
mohegan trail	mohegan trail	100
coast guard station	coast guard station	100
settler's rock	settler's rock	100
martin property	martin property	100
spring street	spring street	100
payne overlook	payne overlook	100
mosquito beach?	mosquito beach	100
library	library	100
black rock beach	black rock beach	100
block island state beach	block island state beach	100
ballard's beach	ballard's beach	100
vaill beach	vaill beach	100
